8 9 7
  ##### 
###   # 
#o@$  #
### $o#
#o##$ #
# # o ##
#$ *$$o#
#   o  #
########
