26 11 4
##########################
#                        #
#      $ ##########      #
#        #               #
#        #               #
#    o   #  @  $         #
#        #               #
#        #               #
#      $      *oo        #
#                        #
##########################
