26 11 4
##########################
#                        #
#      B ##########      #
#        #               #
#        #               #
#    o   #  @  B         #
#        #               #
#        #               #
#      B      *oo        #
#                        #
##########################
