12 10 4
############
#o        o#
# ## ##### #
# # $    # #
# #   $ $  #
# # $  @ # #
# # ###### #
# #        #
#o        o#
############
